5 5 5 5 5 5 5 5 5 5 5 5 5 5 5 5 5 5 5 5 5 5 5 5 5 5 5 5 5 5 5 5 
5 0 0 0 0 0 0 0 0 0 0 0 0 0 0 0 0 0 5 0 0 0 0 0 0 0 0 0 0 0 0 5 
5 0 0 0 0 0 0 0 0 0 0 0 0 0 0 0 0 0 5 0 0 0 0 0 0 0 0 0 0 0 0 5 
5 0 0 0 0 0 0 0 0 0 0 0 0 0 0 0 0 0 5 0 0 0 0 0 0 0 0 0 0 0 0 5 
5 0 0 0 0 0 0 0 0 0 0 0 0 0 0 0 0 0 5 0 0 0 0 0 0 0 0 0 0 0 0 5 
5 0 0 0 0 0 0 0 0 0 0 0 0 0 0 0 0 0 5 0 0 0 0 0 0 0 0 0 0 0 0 5 
5 0 0 0 0 0 0 0 0 0 0 0 0 0 0 0 0 0 5 0 0 0 0 0 0 0 0 0 0 0 0 5 
5 1 0 0 0 0 0 0 0 0 0 0 0 0 0 0 0 0 5 0 0 0 0 0 0 0 0 0 0 0 0 5 
5 5 5 0 0 5 0 0 0 0 0 0 0 0 0 0 0 0 5 0 0 0 0 36 0 45 0 0 0 0 0 5 
5 5 5 0 0 5 0 0 0 0 0 0 0 0 0 0 0 0 5 110 0 0 26 26 26 26 0 0 0 0 103 5 
5 5 5 0 0 5 7 0 0 0 9 10 0 0 0 0 0 8 5 35 35 35 35 35 35 35 35 35 35 35 35 5 
5 5 5 0 0 5 0 0 0 0 0 0 0 0 0 0 0 0 5 6 0 0 0 0 0 0 0 0 0 0 0 5 
5 5 5 0 0 5 0 0 0 0 0 0 0 0 0 0 0 0 5 6 0 0 0 0 0 0 0 0 0 0 0 5 
5 5 5 0 0 5 0 0 0 0 0 0 0 0 0 0 0 0 5 6 0 0 0 0 0 0 37 37 37 37 37 5 
5 5 5 0 0 5 0 0 0 0 0 0 0 0 0 0 0 0 5 6 0 0 0 0 0 0 37 0 0 0 0 5 
5 5 5 0 0 5 0 0 0 0 0 0 0 0 0 0 0 0 5 6 0 0 0 0 0 0 0 0 0 0 102 5 
5 5 5 0 0 5 0 0 0 0 0 0 0 0 0 0 0 0 5 6 0 0 0 0 101 0 0 0 35 35 35 5 
5 5 5 0 0 5 35 0 0 5 0 0 0 0 0 0 0 35 5 6 35 35 35 35 35 35 35 35 35 35 35 5 
5 5 5 0 0 5 0 0 0 5 0 0 0 0 0 0 0 0 5 6 0 0 0 0 0 0 0 0 0 0 0 5 
5 5 5 0 0 5 0 45 0 0 5 0 0 0 0 0 0 0 5 6 0 0 0 0 0 0 0 0 2 0 0 5 
5 5 5 0 0 5 0 0 0 0 5 0 0 0 0 0 0 0 5 6 0 0 2 0 0 0 0 0 2 0 0 5 
5 5 5 0 0 5 11 2 2 5 5 5 5 0 2 0 35 35 5 6 0 2 2 0 0 0 0 2 2 0 0 5 
5 5 5 27 27 5 5 2 2 5 2 5 35 5 100 35 5 5 5 6 2 2 2 0 0 20 0 2 2 0 0 5 
5 5 5 5 5 5 35 35 35 35 35 35 35 35 35 35 35 35 35 35 35 35 35 35 35 35 35 35 35 35 35 5 
