0 0 0 0 0 0 0 0 0 0 0 0 0 0 0 0 0 0 0 0 0 0 0 0 0 0 0 0 0 0 0 0 
0 0 0 0 0 0 0 0 0 0 0 0 0 0 0 0 0 0 0 0 0 0 0 0 0 0 0 0 0 0 0 0 
0 0 0 39 39 39 39 0 0 39 0 0 0 0 0 0 0 0 0 0 0 0 0 0 0 0 0 0 0 0 0 0 
0 0 39 39 39 39 39 39 39 39 39 39 0 39 0 0 0 0 0 0 0 0 0 0 0 0 0 0 0 0 0 0 
0 0 39 101 0 0 0 0 39 39 39 39 39 39 0 0 0 0 0 0 0 0 0 0 0 0 0 0 0 0 0 0 
0 0 39 39 39 39 39 20 0 0 102 39 39 39 0 0 0 0 39 103 0 0 104 39 39 0 0 0 0 0 0 0 
0 0 0 0 0 39 39 39 39 39 39 39 39 0 0 0 0 39 39 39 39 39 39 39 39 0 0 0 0 0 0 0 
0 0 0 0 0 0 0 0 0 0 0 0 0 0 0 0 0 39 39 39 39 39 39 39 39 0 0 0 39 39 39 0 
0 0 0 0 0 0 0 0 0 0 0 0 0 0 0 0 0 0 0 39 39 39 39 39 0 0 0 39 39 39 39 0 
0 0 0 0 39 39 0 0 0 0 0 0 0 0 0 0 0 0 0 0 0 39 39 39 0 0 0 39 39 39 0 0 
0 0 0 39 39 39 39 0 0 0 0 0 0 0 0 0 0 0 0 0 0 0 0 0 0 0 0 0 0 0 0 0 
0 0 0 39 39 39 39 39 0 0 0 0 0 0 0 0 0 0 0 0 0 0 0 0 0 0 0 0 0 0 0 0 
0 0 0 0 0 39 39 0 0 0 0 0 0 0 0 0 0 0 0 0 0 0 0 0 0 0 0 0 0 0 0 0 
0 0 0 0 0 0 0 0 0 0 0 0 0 0 0 0 0 0 0 0 0 0 0 0 0 0 0 0 0 0 0 0 
0 0 0 0 0 0 0 0 0 0 0 0 0 0 0 31 31 0 0 0 0 0 0 0 0 0 0 36 36 36 36 0 
0 0 0 0 0 0 0 0 0 0 0 0 0 0 31 31 31 31 0 0 0 0 0 0 0 0 36 36 36 36 36 36 
0 0 0 0 0 0 0 0 0 0 0 0 0 31 31 26 31 31 31 31 0 0 0 0 0 0 5 5 5 5 5 5 
0 0 0 0 0 0 0 0 0 0 0 0 0 31 31 26 31 31 26 31 0 0 0 0 0 0 5 0 0 0 0 5 
0 0 0 0 0 0 0 0 0 0 0 0 0 0 31 31 26 100 31 31 0 0 0 0 0 0 5 105 0 0 110 5 
0 0 0 0 0 0 0 0 0 0 0 0 0 0 0 0 26 31 0 0 0 0 0 31 0 0 35 35 35 35 35 35 
0 0 0 0 0 0 0 0 0 0 0 0 0 0 0 0 26 0 0 0 0 0 31 26 31 0 0 0 3 0 0 32 
0 0 0 0 0 0 0 1 0 0 0 0 0 25 0 0 26 0 0 0 0 0 29 26 0 0 0 0 3 0 0 37 
27 27 27 27 27 27 27 33 33 33 33 33 33 33 33 33 33 33 33 33 33 33 33 33 37 0 0 0 3 0 37 37 
32 32 32 32 32 32 32 32 32 32 32 32 32 32 32 32 32 32 32 32 32 32 32 37 37 24 24 24 37 37 37 37 
