0 0 0 0 0 0 0 0 0 0 0 0 0 0 0 0 0 0 0 0 0 0 0 0 0 0 0 0 0 0 0 0 
0 0 0 0 0 0 0 0 0 35 35 35 35 35 35 35 35 35 35 35 35 35 35 35 35 35 35 35 35 35 35 0 
0 0 0 0 0 0 0 0 0 35 35 35 35 35 35 35 35 35 35 35 35 35 35 35 35 35 35 35 35 35 35 0 
0 0 0 0 0 0 0 0 0 35 35 35 35 35 35 35 35 35 35 35 35 35 35 35 35 35 35 35 35 35 35 0 
0 0 0 0 0 0 0 0 0 35 35 35 35 35 35 35 35 35 35 35 35 35 35 35 35 35 35 35 35 35 35 0 
0 0 0 0 0 0 0 0 0 35 35 35 35 35 35 35 35 35 35 35 35 35 35 35 35 35 35 35 35 35 35 0 
0 0 0 0 0 0 0 0 0 35 35 35 35 35 35 35 35 35 35 35 35 35 35 35 35 35 35 35 35 35 35 0 
0 0 0 0 0 0 0 0 0 35 35 35 0 35 35 12 35 35 12 35 35 35 35 35 35 35 0 0 0 35 35 0 
0 0 0 0 0 0 0 0 0 0 0 0 0 0 0 12 12 12 12 12 12 12 12 12 12 12 12 12 0 35 35 35 
0 5 5 5 5 5 5 5 0 0 0 0 0 35 35 12 12 12 12 12 12 12 12 12 12 12 12 12 35 35 35 35 
0 5 5 5 5 5 5 5 0 0 0 0 0 35 35 12 12 12 12 12 12 12 12 12 12 12 12 12 0 0 0 0 
0 5 5 5 5 5 5 5 0 0 0 35 35 35 35 12 12 12 12 12 12 12 12 12 12 12 12 12 12 12 12 12 
0 5 5 5 5 5 5 5 0 0 0 35 35 35 35 12 12 0 12 12 12 12 12 12 12 12 12 12 12 12 12 12 
0 5 5 5 5 5 5 5 0 0 35 35 35 35 35 12 0 12 12 12 12 12 0 12 12 12 12 12 12 12 12 12 
0 0 5 0 0 0 0 5 0 35 35 35 35 35 35 12 12 12 12 12 12 12 12 12 12 12 12 12 12 12 12 12 
0 5 5 5 5 5 5 5 0 35 35 35 35 35 35 12 12 12 12 12 12 12 12 12 12 12 12 12 12 12 12 12 
0 5 5 5 5 5 5 5 0 35 35 35 35 35 35 12 12 12 12 12 12 12 12 12 12 12 12 12 12 12 12 12 
0 0 0 0 0 0 0 0 35 35 35 35 35 35 35 12 12 12 12 12 12 12 12 12 12 12 12 12 12 12 12 12 
0 0 0 0 0 0 0 0 0 35 35 35 35 35 35 12 12 12 12 12 12 12 12 12 12 12 12 12 12 12 12 12 
0 0 0 0 0 0 0 0 0 35 0 0 0 0 0 0 0 0 0 0 0 0 12 35 12 12 12 12 12 12 12 12 
0 0 0 0 0 0 0 0 0 0 0 0 0 0 0 0 0 0 0 0 0 0 35 35 35 35 35 35 35 35 35 0 
0 0 0 0 0 0 0 0 0 0 0 0 0 0 0 0 0 0 0 0 0 0 0 35 0 0 0 0 0 0 35 0 
0 0 0 0 0 0 0 0 0 0 0 0 0 0 0 0 0 0 0 0 0 0 0 35 35 35 35 35 35 35 35 0 
0 0 0 0 0 0 0 0 0 0 0 0 0 0 0 0 0 0 0 0 0 0 0 0 0 0 0 0 0 0 0 0 
