5 5 5 5 5 5 5 5 5 5 5 5 5 5 5 5 5 5 5 5 5 5 5 5 5 5 5 5 5 5 5 5 
5 5 102 0 0 0 0 0 0 0 0 0 0 0 0 0 0 0 0 0 0 0 0 0 0 101 0 0 0 0 0 5 
5 5 5 7 0 9 10 0 0 0 0 0 0 0 8 7 0 0 9 10 0 0 0 0 0 0 0 0 0 0 8 5 
5 5 5 0 0 0 0 0 0 0 0 0 0 0 0 0 0 0 0 0 0 0 0 0 0 0 0 0 0 0 0 5 
5 5 5 0 0 0 0 0 0 0 0 0 0 0 0 0 0 0 0 0 0 0 0 0 0 0 0 0 0 0 0 5 
5 5 5 0 0 0 0 0 0 0 0 0 0 0 0 0 0 0 0 0 0 0 0 0 0 0 0 0 0 0 0 5 
5 5 5 0 0 0 0 0 0 0 0 0 0 0 0 0 0 0 0 0 0 0 0 0 0 0 0 0 0 0 0 5 
5 5 5 0 0 0 0 0 0 0 0 0 0 0 0 0 0 0 0 0 0 0 0 0 0 0 0 0 0 0 0 5 
5 5 5 0 0 0 0 0 0 0 0 0 0 0 0 0 0 0 0 0 0 0 0 0 0 0 0 0 0 0 0 5 
5 5 5 0 0 0 0 0 0 24 24 24 0 0 0 0 0 0 0 0 0 0 0 0 0 0 0 0 0 0 0 5 
5 5 5 0 0 0 0 0 0 36 36 36 0 0 0 0 0 0 0 0 0 0 0 0 0 0 0 0 0 0 0 5 
5 5 5 0 0 0 0 0 0 36 2 36 0 0 0 0 0 0 0 0 0 0 0 0 0 0 0 0 0 0 0 5 
5 103 5 0 0 0 0 0 0 36 2 36 0 0 0 0 0 0 0 0 0 0 0 0 0 0 0 0 0 0 0 5 
5 0 5 0 0 0 0 0 0 36 2 36 0 0 0 0 0 0 0 0 0 0 0 0 0 0 0 0 0 0 0 5 
5 110 5 0 0 0 29 0 0 36 2 36 27 27 27 27 27 27 27 27 27 27 27 27 27 27 27 27 27 27 27 5 
5 5 5 36 36 36 36 36 36 36 2 36 36 36 36 36 36 36 36 36 36 36 36 36 36 36 36 36 36 36 36 5 
5 0 0 0 0 0 0 29 0 0 2 0 0 0 0 0 0 0 0 0 0 0 0 0 0 0 0 0 0 20 100 5 
5 5 5 5 5 5 6 5 5 5 5 0 23 23 23 23 23 23 23 23 23 12 12 12 12 12 12 12 12 5 5 5 
5 5 5 5 5 5 6 5 5 5 5 0 5 5 5 5 5 5 5 5 5 0 0 0 0 0 0 0 0 5 5 5 
5 5 5 5 5 5 6 5 5 5 5 0 5 5 5 5 5 5 5 5 5 0 0 0 0 0 0 0 0 5 5 5 
5 5 5 5 5 5 6 5 5 5 5 0 5 5 5 5 5 5 5 5 5 0 0 0 0 0 0 0 0 5 5 5 
5 0 0 0 0 3 6 3 0 0 5 0 5 5 5 5 5 5 5 5 5 0 0 0 0 0 0 0 0 5 5 5 
5 0 1 0 25 3 6 3 0 0 5 0 5 5 5 5 5 5 5 5 5 24 24 24 24 24 24 24 24 5 5 5 
5 5 5 5 5 5 5 5 5 5 5 5 5 5 5 5 5 5 5 5 5 5 5 5 5 5 5 5 5 5 5 5 
