0 0 0 0 0 0 0 0 0 0 0 0 0 0 0 0 0 0 0 0 0 0 0 0 0 0 0 0 0 0 0 0 
0 0 0 0 0 0 0 0 0 0 0 0 0 0 0 0 0 0 0 0 0 0 0 0 0 0 0 0 0 0 0 0 
0 0 0 0 0 0 0 0 0 0 0 0 0 0 0 0 0 0 0 0 0 0 0 0 0 0 0 0 0 0 0 0 
0 0 0 0 0 0 0 0 0 39 39 39 0 0 0 0 0 0 0 0 0 0 0 0 0 0 0 0 0 0 0 0 
0 0 0 0 0 0 0 0 39 39 39 39 39 39 39 0 0 0 0 0 0 0 0 0 0 0 0 0 0 0 0 0 
0 0 0 0 0 0 0 39 39 39 39 39 39 39 39 0 0 0 0 0 0 0 0 0 39 39 39 39 39 0 0 0 
0 0 0 0 0 0 0 39 39 39 39 39 39 39 0 0 0 0 0 0 0 0 0 39 39 39 39 39 39 39 0 0 
0 0 0 0 0 0 0 0 0 39 39 0 0 0 0 0 0 0 0 0 0 0 0 0 39 39 39 39 39 39 0 0 
0 0 0 0 0 0 0 0 0 0 0 0 0 0 0 0 0 0 0 0 0 0 0 0 0 0 0 0 0 0 0 0 
0 0 0 0 0 0 0 0 0 0 0 0 0 0 0 0 0 0 0 0 0 0 0 0 0 0 0 0 0 0 0 0 
0 0 0 0 0 0 0 0 0 0 0 0 0 0 0 0 0 0 0 0 0 0 0 0 0 0 0 0 0 0 0 0 
0 0 0 0 0 0 0 0 0 0 0 0 0 0 0 0 0 0 0 0 0 0 0 0 0 0 0 0 0 0 0 0 
0 0 0 0 0 0 0 0 0 0 0 0 0 0 0 0 0 0 0 0 0 0 0 0 0 0 0 0 0 0 0 0 
0 0 0 0 0 0 0 0 0 0 0 0 0 0 0 0 0 0 0 0 0 0 0 0 0 0 0 0 0 0 0 0 
0 0 36 36 36 36 36 36 0 0 0 0 0 0 0 0 0 0 31 31 31 31 0 0 0 0 0 0 0 0 0 0 
0 36 36 36 36 36 36 36 36 0 0 0 0 0 0 0 31 31 26 31 26 31 0 0 0 0 0 0 0 0 0 0 
36 36 36 36 36 36 36 36 36 36 0 0 0 0 0 0 31 26 31 26 31 31 0 0 0 0 0 0 0 0 0 0 
0 5 5 5 5 5 5 5 5 0 0 31 0 0 0 0 0 31 26 26 26 31 0 0 0 0 31 31 31 0 31 31 
0 5 6 0 0 0 0 0 5 0 31 31 31 0 0 0 0 31 31 26 31 0 0 0 0 31 26 31 26 31 31 26 
0 5 6 0 0 44 0 20 5 0 31 26 31 0 0 0 0 0 0 26 0 0 0 0 0 0 31 26 31 0 0 31 
0 5 6 35 35 35 35 35 5 0 0 26 0 1 0 0 0 0 0 26 0 0 0 0 0 0 0 26 0 0 0 33 
0 5 6 0 0 0 0 0 0 0 0 26 0 25 0 0 0 0 0 26 0 0 0 0 0 0 0 26 0 0 110 32 
33 35 35 35 35 35 35 35 35 35 33 33 33 33 33 33 33 33 33 33 33 33 33 33 33 33 33 33 33 33 33 32 
32 32 32 32 32 32 32 32 32 32 32 37 32 32 37 37 32 32 32 32 32 32 32 37 32 32 32 32 32 32 32 37 
