0 0 0 0 0 0 0 0 0 0 0 0 0 0 0 0 0 0 0 0 0 0 0 0 0 0 0 0 0 0 0 0 
0 0 0 0 0 0 0 0 0 0 0 0 0 0 0 0 0 0 0 0 0 0 0 0 0 0 0 0 0 0 0 0 
0 0 0 0 0 0 0 0 0 0 0 0 0 0 0 0 0 0 0 0 0 0 0 0 0 0 0 0 0 0 0 0 
0 0 39 39 0 0 0 0 0 0 0 0 0 0 0 0 0 0 0 0 0 0 0 0 0 0 0 39 39 39 0 0 
0 39 39 39 39 0 0 0 0 0 0 0 0 0 0 0 0 0 0 0 0 0 0 0 0 0 39 39 39 39 0 0 
0 0 39 39 0 0 0 0 0 0 0 0 0 0 0 0 0 0 0 0 0 0 0 0 0 0 0 39 39 39 39 0 
0 0 0 0 0 0 0 0 0 0 0 0 0 0 0 0 0 39 39 39 0 0 0 0 0 0 0 0 39 39 0 0 
0 0 0 0 0 0 0 31 31 31 31 31 31 0 0 0 39 39 39 39 39 0 0 0 0 0 0 0 0 0 0 0 
0 0 0 0 0 31 31 31 31 31 31 31 31 31 31 0 0 39 39 39 0 0 0 0 0 0 0 0 0 0 0 0 
0 0 0 0 0 31 31 26 31 31 26 31 31 31 31 0 0 0 0 0 0 0 0 0 0 0 0 0 0 0 0 0 
0 0 0 0 31 31 31 26 31 31 26 31 31 31 31 0 0 0 0 0 0 0 0 0 0 0 0 0 0 0 0 0 
0 0 0 0 31 31 31 31 26 31 26 31 31 26 31 0 0 0 0 0 0 0 0 0 0 0 0 0 0 0 0 0 
0 0 0 0 31 26 31 31 31 26 31 31 31 26 31 0 0 0 0 0 0 0 0 0 0 0 0 0 0 0 0 0 
0 0 0 31 31 26 31 31 31 26 31 31 26 31 31 0 0 0 0 0 0 0 0 0 0 0 0 0 0 0 0 0 
0 0 0 0 31 31 26 26 31 26 31 26 31 31 0 0 0 0 0 0 0 0 0 0 0 0 0 0 0 0 0 0 
0 0 0 0 31 31 31 31 26 26 26 31 31 0 0 0 0 0 0 0 0 0 0 0 0 0 0 0 0 0 0 0 
0 0 0 0 0 0 31 31 31 26 31 31 0 0 0 0 0 0 0 0 0 0 0 0 0 0 0 0 0 0 0 37 
37 0 0 0 0 0 0 0 0 26 0 0 0 0 0 0 0 0 0 0 0 0 0 0 0 0 0 0 0 0 0 37 
37 0 0 0 0 0 0 0 0 26 0 0 0 0 0 0 0 0 0 0 0 0 0 0 0 0 0 0 0 0 0 37 
37 0 0 0 0 0 0 0 0 26 0 0 0 0 0 0 0 0 0 0 0 0 0 0 0 0 0 0 0 0 37 37 
37 37 1 0 0 0 0 25 0 26 0 0 0 0 0 0 0 0 0 0 0 0 0 0 0 0 0 0 20 110 37 37 
37 37 33 33 33 37 33 33 33 33 33 33 33 33 33 37 37 32 32 32 37 37 37 37 37 37 37 37 37 37 37 37 
37 37 37 37 37 37 37 32 37 32 37 37 37 37 37 32 32 37 37 37 37 37 32 32 32 37 37 37 37 37 37 37 
32 37 37 37 37 37 37 37 37 37 37 37 37 37 37 37 37 37 32 37 37 32 37 37 37 37 37 37 37 32 37 37 
