0 0 0 0 0 0 0 0 0 0 0 0 0 0 0 0 0 0 0 0 0 0 0 0 0 0 0 0 0 0 0 0 
0 0 0 0 0 0 0 0 0 0 0 0 0 0 0 0 0 0 0 0 0 0 0 0 0 0 0 0 0 0 0 0 
0 0 0 0 39 39 0 0 0 0 0 0 0 0 0 0 0 0 0 0 0 0 0 0 0 0 0 0 0 0 0 0 
0 0 0 39 39 39 39 0 0 0 0 0 0 0 0 0 0 0 0 0 0 0 0 0 0 0 0 0 0 0 0 0 
0 0 0 0 39 39 39 39 0 0 0 0 0 0 0 0 0 0 0 0 0 0 0 0 0 0 0 0 0 0 0 0 
0 0 0 0 0 39 39 0 0 0 0 0 0 0 0 0 0 0 39 39 39 0 0 0 0 0 0 0 0 0 0 0 
0 0 0 0 0 0 0 0 0 0 0 0 0 0 0 0 0 39 39 39 39 39 0 0 0 0 0 0 0 0 0 0 
0 0 0 0 0 0 0 0 0 0 0 0 0 0 0 0 0 0 0 39 39 0 0 0 0 0 0 0 0 0 0 0 
0 0 0 0 0 0 0 0 0 0 0 0 0 0 0 0 0 0 0 0 0 0 0 0 0 0 0 0 0 0 0 0 
0 0 0 0 0 0 0 0 0 0 0 0 0 0 0 0 0 0 0 0 0 0 0 0 0 0 0 0 39 39 0 0 
0 0 0 0 0 0 0 0 0 0 0 0 0 0 0 0 0 0 0 0 0 0 0 0 0 0 0 39 39 39 39 0 
0 0 0 0 0 0 0 0 0 0 0 0 0 0 0 0 0 0 0 0 0 0 0 0 0 0 0 0 39 39 0 0 
0 0 0 0 0 0 0 0 0 0 0 0 0 0 0 0 0 0 0 0 0 0 0 0 0 0 0 0 0 0 0 0 
0 0 0 0 0 0 0 0 0 0 31 31 31 31 31 31 0 0 0 0 0 0 0 0 0 0 0 0 0 0 0 0 
0 0 0 0 0 0 0 0 0 31 26 31 31 26 31 26 31 0 0 33 33 33 0 0 0 0 0 0 0 0 0 0 
0 0 0 0 0 0 0 0 0 31 31 26 31 26 31 26 31 0 33 32 32 32 33 0 0 0 0 0 0 0 0 0 
0 0 0 0 0 6 20 0 0 31 31 31 26 31 31 26 31 0 32 32 32 32 32 0 0 0 0 0 0 0 0 0 
0 0 0 0 36 6 36 0 0 31 31 26 26 31 26 31 31 0 32 32 37 32 32 0 0 0 0 0 0 0 0 0 
0 0 0 36 36 6 36 36 0 0 31 31 31 26 31 31 0 33 32 32 37 32 32 0 0 0 0 0 0 0 0 0 
0 0 0 35 35 6 35 35 0 0 0 0 0 26 0 0 0 32 32 32 37 32 32 0 0 0 0 0 0 0 0 0 
0 0 0 35 0 6 0 35 0 0 0 0 0 26 0 0 0 32 32 37 37 32 32 0 0 0 0 0 0 0 0 0 
0 1 0 0 0 6 0 0 0 0 34 25 0 26 0 100 33 32 32 37 37 32 32 33 101 0 34 34 0 110 0 0 
27 33 33 35 35 35 35 35 33 33 33 33 33 33 33 33 32 32 37 37 37 37 32 32 33 33 33 33 33 33 27 27 
32 32 32 32 32 32 32 32 32 32 32 32 32 32 32 32 32 32 37 37 37 37 32 32 32 32 32 32 32 32 32 32 
