12 12 12 12 12 12 12 12 12 35 35 35 35 35 35 35 35 35 35 35 35 35 35 35 35 35 35 35 35 35 35 35 
12 101 0 0 0 0 0 0 12 0 0 0 0 0 0 0 0 0 0 0 0 0 0 0 0 0 0 0 0 0 0 35 
12 0 0 0 0 0 0 0 12 0 0 0 0 0 0 0 0 0 0 0 0 0 0 0 0 0 0 0 0 0 0 35 
12 0 0 0 0 0 0 0 0 0 0 0 0 0 0 0 0 0 0 0 0 0 0 0 0 0 0 0 0 0 0 35 
12 0 0 0 0 0 0 0 0 0 0 0 0 0 0 0 0 0 0 0 0 0 0 0 0 0 0 0 0 0 0 35 
12 12 12 12 12 12 12 12 12 7 9 10 0 0 0 0 0 0 0 0 0 0 0 0 0 0 0 0 0 0 8 35 
0 0 0 0 0 0 0 0 0 35 24 24 24 24 24 24 24 24 24 24 24 24 24 24 24 24 24 24 24 0 0 35 
11 11 11 11 11 11 11 11 11 35 35 35 35 35 35 35 35 35 35 35 35 35 35 35 35 35 35 35 35 0 35 35 
5 5 5 5 5 5 5 5 5 35 35 35 35 35 35 12 0 105 0 12 12 12 12 0 0 0 0 0 5 0 0 0 
5 106 0 100 0 102 0 104 5 35 35 35 35 35 0 12 0 0 0 20 0 0 0 0 0 0 0 0 5 23 23 27 
5 6 0 6 0 6 0 6 5 35 35 35 35 0 0 12 0 0 0 22 22 22 22 22 12 12 12 0 5 5 5 5 
5 6 0 6 0 6 0 6 5 35 35 35 0 0 0 12 24 24 24 12 12 12 12 0 0 0 0 0 0 0 0 0 
5 6 0 6 0 6 0 6 5 35 35 0 0 0 0 12 12 12 12 12 12 12 12 0 0 0 0 0 0 0 0 0 
5 6 0 6 0 6 0 6 5 35 0 0 0 0 0 12 12 12 12 12 12 12 12 0 0 0 0 40 0 0 0 0 
5 5 5 5 5 5 5 6 5 103 0 0 0 0 0 12 12 12 12 12 12 12 12 12 12 12 12 28 12 12 12 0 
5 0 0 0 0 0 0 6 5 0 0 0 0 0 0 12 107 0 0 0 0 0 0 0 0 0 0 0 0 0 0 0 
5 1 0 0 0 0 0 6 5 0 0 0 0 0 0 12 0 0 0 0 0 0 0 0 0 0 0 0 0 0 0 0 
5 5 5 5 5 5 5 5 5 0 0 0 0 0 0 12 0 0 0 0 0 0 0 0 0 0 0 0 0 0 0 0 
5 5 5 5 5 5 5 5 5 0 0 0 0 29 0 12 0 0 0 0 0 0 40 0 0 0 0 0 0 0 0 40 
5 5 5 5 5 5 5 5 5 0 5 5 5 5 5 5 5 5 5 5 5 5 28 6 5 5 5 5 5 5 5 28 
0 0 0 0 0 0 0 0 0 0 0 0 0 0 0 0 0 0 0 0 0 5 5 6 0 0 0 0 0 0 0 12 
12 12 12 12 12 12 12 12 12 12 12 12 12 12 12 12 12 12 12 12 12 5 5 6 35 35 35 35 35 35 35 12 
11 11 11 11 11 11 11 11 11 11 11 11 11 11 11 11 11 11 11 11 11 5 5 6 0 0 0 0 0 0 110 12 
5 5 5 5 5 5 5 5 5 5 5 5 5 5 5 5 5 5 5 5 5 5 5 12 12 12 12 12 12 12 12 12 
