0 0 0 0 0 0 0 0 0 0 0 0 0 0 0 0 0 0 0 0 0 0 0 0 0 0 0 0 0 0 0 0 
0 0 0 0 0 0 0 0 0 0 0 0 0 0 0 0 0 0 0 0 0 0 0 0 0 0 0 0 0 0 0 0 
0 0 0 0 0 0 0 0 0 0 0 0 0 0 0 0 0 0 0 0 0 0 0 0 0 0 0 0 0 0 0 0 
0 0 0 0 0 0 0 0 0 39 39 39 0 0 0 0 0 0 0 0 0 0 0 0 0 0 0 0 0 0 0 0 
0 0 0 0 0 0 0 0 39 39 39 39 39 39 39 0 0 0 0 0 0 0 0 0 0 0 0 0 0 0 0 0 
0 0 0 0 0 0 0 39 39 39 39 39 39 39 39 0 0 0 0 0 0 0 0 0 39 39 39 39 39 0 0 0 
0 0 0 0 0 0 0 39 39 39 39 39 39 39 0 0 0 0 0 0 0 0 0 39 39 39 39 39 39 39 0 0 
0 0 0 0 0 0 0 0 0 39 39 0 0 0 0 0 0 0 0 0 0 0 0 0 39 39 39 39 39 39 0 0 
0 0 0 0 0 0 0 0 0 0 0 0 0 0 0 0 0 0 0 0 0 0 0 0 0 0 0 0 0 0 0 0 
0 0 0 0 0 0 0 0 0 0 0 0 0 0 0 0 0 0 0 0 0 0 0 0 0 0 0 0 0 0 0 0 
0 0 0 0 0 0 0 0 0 0 0 0 0 0 0 0 0 0 0 0 0 0 0 0 0 0 0 0 0 0 0 0 
0 0 0 0 0 0 0 0 0 0 0 0 0 0 0 0 0 0 0 0 0 0 0 0 0 0 0 0 0 0 0 0 
0 0 0 0 0 0 0 0 0 0 0 0 0 0 0 0 0 0 0 0 0 0 0 0 0 0 0 0 0 0 0 0 
0 0 0 0 0 0 47 0 0 0 0 0 0 0 0 0 0 0 0 0 0 0 0 0 0 0 0 0 0 0 0 0 
0 0 36 36 36 36 36 36 0 0 0 0 0 0 0 0 0 0 31 31 31 31 0 0 0 0 0 0 0 0 0 0 
0 36 36 36 36 36 36 36 36 0 0 0 0 0 0 0 31 31 31 31 26 31 0 0 0 0 0 0 0 0 0 0 
36 36 36 36 36 36 36 36 36 36 0 0 0 0 0 0 31 26 31 26 31 31 0 0 0 0 0 0 0 0 0 0 
0 5 5 5 5 5 5 5 5 49 0 31 0 0 0 0 0 31 26 26 26 31 0 0 0 0 31 31 31 0 0 0 
0 5 6 0 0 0 0 0 5 49 31 31 31 0 0 0 0 31 31 26 31 0 0 0 0 31 26 31 31 31 0 0 
0 5 6 0 0 44 0 20 5 49 31 26 31 0 0 0 0 0 0 26 0 0 0 0 0 0 31 26 31 46 0 0 
0 5 6 35 35 35 35 35 5 0 0 26 0 0 0 0 0 0 0 26 0 0 0 0 0 0 0 26 0 46 0 33 
0 5 6 1 0 0 0 0 0 0 34 26 0 25 34 0 34 34 34 26 0 34 0 47 34 34 0 26 0 46 110 32 
33 35 35 35 35 35 35 35 35 35 33 33 33 33 33 33 33 33 33 33 33 33 33 33 33 33 33 33 33 33 33 32 
32 32 32 32 32 32 32 32 32 32 32 37 32 32 32 32 32 32 32 32 32 32 32 37 32 32 32 32 32 32 32 37 
