5 5 5 5 5 5 5 5 5 5 5 5 5 5 5 35 35 35 35 35 35 35 35 35 35 35 35 35 35 35 35 35 
5 0 0 0 0 0 0 0 0 0 0 0 0 0 5 0 0 0 0 0 0 0 0 0 0 0 0 0 0 0 0 35 
5 0 0 0 0 0 0 0 0 0 0 0 0 0 5 0 0 0 0 0 0 0 0 0 0 0 0 0 0 0 0 35 
5 0 0 0 0 0 0 0 0 0 0 0 0 0 5 0 0 0 0 0 0 0 0 0 0 0 0 0 0 0 0 35 
5 0 0 0 0 0 0 0 0 0 0 0 0 0 5 0 0 0 0 0 0 0 0 0 0 0 0 0 0 0 0 35 
5 20 0 6 0 0 0 0 0 0 0 0 0 102 5 0 0 0 0 0 0 0 0 0 0 0 0 0 0 0 0 35 
5 5 5 6 5 7 0 9 10 0 0 0 0 8 5 0 0 0 0 0 0 0 0 0 0 0 0 0 29 0 0 35 
5 0 0 6 0 5 24 11 24 11 24 11 24 5 5 0 0 0 0 0 0 0 0 0 0 0 36 36 36 36 36 36 
5 0 0 6 0 5 5 5 5 5 5 5 5 5 5 0 0 0 0 0 0 0 0 0 0 0 36 0 0 0 0 36 
5 0 0 6 0 5 5 5 5 5 5 5 5 5 5 0 0 0 0 0 0 0 0 0 0 0 36 0 0 0 110 36 
5 0 0 6 0 5 5 5 5 5 5 5 5 5 5 0 0 0 0 0 0 0 0 0 0 0 36 0 36 36 36 36 
5 101 0 6 0 5 5 5 5 5 5 5 5 5 5 0 0 0 0 0 0 0 0 0 0 0 36 0 0 0 0 36 
5 5 5 5 5 5 5 5 5 5 5 5 5 5 5 0 0 0 0 0 0 0 0 0 0 100 36 40 0 0 103 36 
35 0 0 0 0 0 0 0 0 0 0 0 0 0 0 0 0 35 35 35 35 35 35 35 35 35 36 28 36 36 36 36 
35 0 0 0 0 0 0 0 0 0 0 0 0 0 0 0 0 35 35 35 35 35 35 35 35 35 36 36 36 36 36 36 
35 0 0 0 0 0 0 0 0 0 0 0 0 0 0 0 0 35 35 35 35 35 35 35 35 37 37 37 37 37 37 37 
35 0 0 0 0 0 0 0 0 0 0 0 0 0 0 0 0 35 35 35 35 35 35 35 35 37 37 37 37 37 37 37 
35 0 0 0 0 0 0 0 0 0 0 0 0 0 0 0 0 35 35 35 35 35 35 35 35 37 37 37 37 37 37 37 
35 0 0 0 0 0 0 0 0 0 0 0 0 0 0 0 0 35 35 35 35 35 35 35 35 37 37 37 37 37 37 37 
35 0 0 0 0 0 0 0 0 0 0 0 0 0 0 0 0 35 35 35 35 35 35 35 37 37 37 37 37 37 37 37 
35 0 0 0 0 0 0 0 0 0 0 0 0 0 0 0 0 35 35 35 35 35 35 37 37 37 37 37 37 37 37 37 
35 1 25 40 0 0 0 0 0 0 0 0 0 0 0 40 40 35 35 35 35 35 37 37 37 37 37 37 37 37 37 37 
35 35 35 28 11 11 11 35 35 35 35 35 35 35 35 28 28 35 35 35 35 35 35 35 37 35 37 35 37 37 35 37 
35 35 35 35 35 35 35 35 35 35 35 35 35 35 35 35 35 35 35 35 35 35 35 35 35 37 35 35 37 37 35 35 
