0 0 0 0 0 0 0 0 0 0 0 0 0 0 0 0 0 0 0 0 0 0 0 0 0 0 0 0 0 0 0 0 
0 0 0 0 0 0 0 0 0 0 0 0 0 0 0 0 0 0 0 0 0 0 0 0 0 0 0 0 0 0 0 0 
0 0 0 0 0 0 0 0 0 0 0 0 0 0 0 0 0 0 0 0 0 0 0 0 0 0 0 0 0 0 0 0 
0 0 0 0 0 0 0 0 0 0 0 0 0 0 0 0 0 0 0 0 0 0 0 0 0 0 54 0 0 0 0 0 
0 0 0 0 0 0 0 0 0 0 0 0 0 0 0 0 0 0 0 0 0 0 0 0 0 54 54 54 0 0 0 0 
0 0 0 0 0 0 0 0 0 0 0 0 0 0 0 0 0 0 0 0 0 0 0 0 0 54 54 54 0 0 63 61 
58 0 0 0 0 0 0 0 0 0 0 0 0 0 0 0 0 0 0 0 0 0 0 0 0 54 54 54 0 0 63 61 
58 0 0 0 0 0 0 0 0 0 0 0 0 0 0 0 0 0 0 0 0 0 0 0 0 54 54 54 0 0 63 61 
58 0 0 0 0 0 0 0 0 0 0 0 0 0 0 0 0 0 0 0 0 0 0 0 54 54 54 54 54 0 63 61 
58 58 0 0 0 0 0 0 0 0 0 0 0 0 0 0 0 0 0 0 0 0 0 0 54 54 52 54 54 0 63 61 
58 58 58 0 0 0 0 0 0 0 60 0 0 0 0 0 0 0 0 0 0 0 0 0 54 54 52 54 54 0 63 61 
58 0 58 58 58 58 56 56 56 56 60 56 56 0 0 0 0 0 0 0 0 0 0 0 54 54 52 54 54 0 63 61 
58 1 58 58 58 58 58 58 58 58 60 58 58 58 58 0 0 0 0 0 0 0 0 0 0 0 52 0 0 0 63 61 
58 0 0 0 0 0 0 0 0 0 60 0 0 58 58 58 58 0 0 0 0 0 0 0 0 0 52 0 0 0 63 61 
58 0 0 0 0 0 0 0 0 0 60 0 0 0 0 58 58 58 58 58 0 0 0 0 0 0 11 11 11 11 11 11 
58 58 58 58 58 58 58 58 58 58 58 0 0 0 0 0 0 0 0 58 58 11 11 11 11 11 8 8 8 8 8 8 
58 58 58 58 58 58 58 58 58 58 58 58 58 58 0 0 49 0 0 58 58 8 8 8 8 8 8 0 8 8 0 8 
0 0 0 0 0 0 0 0 0 0 0 0 0 58 58 58 58 53 53 58 58 0 0 0 0 0 0 0 0 0 0 0 
0 0 0 0 0 0 0 0 0 0 0 0 0 0 0 0 0 0 0 0 0 0 0 0 0 0 0 0 0 0 0 0 
0 0 0 0 0 0 0 0 0 0 0 0 0 0 0 0 0 0 0 0 0 0 0 0 0 0 0 0 0 0 0 0 
0 0 0 0 0 0 0 0 0 0 0 0 0 0 0 0 0 0 0 0 0 0 0 0 0 0 0 0 0 0 0 0 
0 0 0 0 0 0 0 0 0 0 0 0 0 0 0 0 0 0 0 0 0 0 0 0 0 0 0 0 0 0 0 0 
0 0 0 0 0 0 0 0 0 0 0 0 0 0 0 0 0 0 0 0 0 0 0 0 0 0 0 0 0 0 0 0 
0 0 0 0 0 0 0 0 0 0 0 0 0 0 0 0 0 0 0 0 0 0 0 0 0 0 0 0 0 0 0 0 
