0 0 0 0 0 0 0 0 0 0 0 0 0 0 0 0 0 0 0 0 0 0 0 0 0 0 0 0 0 0 0 0 
0 0 0 0 0 0 0 0 0 0 0 0 0 0 0 0 0 0 0 0 0 0 0 0 0 0 0 0 0 0 0 0 
0 0 0 0 0 0 0 0 0 0 0 0 0 0 0 0 0 0 0 0 0 0 0 0 0 0 0 0 0 0 0 0 
0 0 0 0 0 0 0 0 0 0 0 0 0 0 0 0 0 0 0 0 0 0 0 0 0 0 0 0 0 0 0 0 
0 0 0 0 0 0 0 0 0 0 0 0 0 0 0 0 0 0 0 0 0 0 0 0 0 0 0 0 0 0 0 0 
0 0 0 0 0 0 0 0 0 0 0 0 0 0 0 0 0 0 0 0 0 0 0 0 0 0 0 0 0 0 0 0 
0 0 0 54 54 54 0 0 0 0 0 0 0 0 0 0 54 54 54 54 54 54 0 0 0 0 0 0 0 0 0 58 
0 0 54 54 52 54 54 0 54 54 54 54 54 54 54 54 54 54 54 54 54 54 0 54 54 54 0 0 0 0 0 58 
0 54 0 54 52 54 0 54 0 0 54 54 54 0 54 54 54 54 54 54 54 54 54 54 54 54 54 0 0 0 0 58 
0 54 54 54 52 54 54 54 54 54 54 54 54 54 0 54 54 54 52 54 54 54 54 54 54 52 54 54 0 0 0 58 
0 54 54 54 52 54 0 0 54 54 52 54 54 0 0 0 54 54 52 54 54 0 0 54 54 52 54 0 0 0 58 58 
0 0 0 54 52 0 0 0 0 0 52 0 0 0 0 0 0 0 52 0 0 0 0 0 0 52 0 0 0 0 58 58 
0 0 0 0 52 0 0 0 0 0 52 0 0 0 0 0 0 0 52 0 0 0 0 0 0 52 0 0 0 0 63 61 
0 0 0 0 52 0 0 0 0 0 52 0 0 0 0 0 0 0 52 55 0 0 0 58 0 52 0 0 55 58 11 11 
0 0 0 0 52 1 0 0 0 55 52 49 0 55 0 0 58 11 11 11 11 11 11 11 11 11 11 11 11 11 8 8 
53 53 53 53 11 11 11 11 11 11 11 11 11 11 11 11 11 8 8 8 8 8 8 8 8 8 8 8 8 8 8 8 
8 8 8 8 8 8 8 8 8 8 8 8 8 8 8 8 8 8 8 8 8 8 8 8 8 8 8 8 8 8 8 8 
8 8 8 8 8 8 8 8 8 8 8 8 8 8 8 8 8 8 8 8 8 8 8 8 8 8 8 8 8 8 8 8 
8 8 8 8 8 8 8 8 8 8 8 8 8 8 8 8 8 8 8 8 8 8 8 8 8 8 8 8 8 8 8 8 
8 8 8 8 8 8 8 8 8 8 8 8 8 8 8 8 8 8 8 8 8 8 8 8 8 8 8 8 8 8 8 8 
8 8 8 8 8 8 8 8 8 8 8 8 8 8 8 8 8 8 8 8 8 8 8 8 8 8 8 8 8 8 8 8 
8 8 8 8 8 8 8 8 8 8 8 8 8 8 8 8 8 8 8 8 8 8 8 8 8 8 8 8 8 8 8 8 
8 8 8 8 8 8 8 8 8 8 8 8 8 8 8 8 8 8 8 8 8 8 8 8 8 8 8 8 8 8 8 8 
8 8 8 8 8 8 8 8 8 8 8 8 8 8 8 8 8 8 8 8 8 8 8 8 8 8 8 8 8 8 8 8 
