0 0 0 0 0 0 0 0 0 0 0 0 0 0 0 0 0 0 0 0 0 0 0 0 0 0 0 0 0 0 0 0 
0 0 0 0 0 0 0 0 0 0 0 0 0 0 0 0 0 0 0 0 0 0 0 0 0 0 0 0 0 0 0 0 
0 0 0 0 0 0 0 0 0 0 0 0 0 0 0 0 0 0 0 0 0 0 0 0 0 0 0 0 0 0 0 0 
0 0 0 0 0 0 0 0 0 0 0 0 0 0 0 0 0 0 0 0 0 0 0 0 0 0 0 0 0 0 0 0 
0 0 0 0 0 0 0 0 0 0 0 0 0 0 0 0 0 0 0 0 0 0 0 0 0 0 0 0 0 0 0 0 
0 0 0 0 0 0 0 0 0 0 0 0 0 0 0 0 0 0 0 0 0 0 0 0 0 0 0 0 0 0 0 0 
0 0 0 0 0 0 0 0 0 0 0 0 0 0 0 0 0 0 0 0 0 0 0 0 0 0 0 0 0 0 0 0 
65 67 0 0 0 0 0 0 0 0 0 0 0 0 0 0 0 0 0 0 0 0 0 0 0 0 0 0 0 0 0 0 
65 0 0 0 0 0 0 0 0 0 0 0 0 0 0 0 0 0 0 0 0 0 0 0 0 0 0 0 0 0 0 0 
65 0 1 0 0 0 0 0 0 0 0 0 0 0 0 0 0 0 0 0 0 0 0 0 0 0 0 0 0 0 0 0 
65 60 0 0 0 0 0 0 0 0 0 0 0 0 0 0 0 0 0 0 0 0 0 0 0 0 0 0 0 0 0 0 
65 60 0 0 0 0 0 0 0 0 0 0 0 0 0 0 0 0 0 0 0 0 0 0 25 0 0 0 0 0 0 0 
65 60 65 65 65 65 65 65 65 65 65 65 65 65 65 65 65 65 65 65 65 65 65 65 65 0 0 0 0 0 0 0 
65 60 65 65 65 65 65 65 65 65 65 65 65 65 65 65 65 65 65 65 65 65 69 65 65 0 0 0 0 0 0 0 
65 60 65 0 0 0 0 0 0 0 0 0 0 0 0 0 0 65 0 0 0 0 0 65 65 0 0 0 0 0 0 0 
65 60 65 0 0 0 0 0 0 0 0 0 0 0 0 0 0 65 0 0 0 0 110 65 67 0 0 0 0 0 0 0 
65 60 0 0 20 20 20 20 20 20 20 20 20 20 20 20 0 0 0 0 0 0 65 67 0 0 0 0 0 0 0 0 
65 60 0 0 0 0 0 0 0 0 0 0 0 0 0 0 0 0 0 70 0 65 67 0 0 0 0 0 0 0 0 0 
65 60 65 65 65 65 65 65 65 65 65 65 65 65 65 65 65 65 65 65 65 67 53 53 53 53 53 53 53 53 53 53 
65 60 65 0 0 0 0 0 0 0 0 0 0 0 58 59 59 65 65 65 67 68 68 68 68 68 68 68 68 68 68 68 
65 60 0 0 0 0 0 0 0 0 0 0 24 57 58 59 59 65 65 67 68 68 68 68 68 68 68 68 68 68 68 68 
65 60 0 0 0 0 0 0 0 56 56 0 57 58 58 59 59 65 67 68 68 68 68 68 68 68 68 68 68 68 68 68 
65 65 65 65 65 65 65 65 65 65 65 65 65 65 65 65 65 67 68 68 68 68 68 68 68 68 68 68 68 68 68 68 
68 68 68 68 68 68 68 68 68 68 68 68 68 68 68 68 68 68 68 68 68 68 55 55 55 55 68 68 68 68 68 68 
