0 0 0 0 0 0 0 0 0 0 0 0 0 0 0 0 0 0 0 0 0 0 0 0 0 0 0 0 0 0 0 0 
0 0 0 0 0 0 0 0 0 0 0 0 0 0 0 0 0 0 0 0 0 0 0 0 0 0 0 0 0 0 0 0 
0 0 0 0 0 0 0 0 0 0 0 0 0 0 0 0 0 0 0 0 0 0 0 0 0 0 0 0 0 0 0 0 
0 0 0 0 0 0 0 0 0 0 0 0 0 0 0 0 0 0 0 0 0 0 0 0 0 0 0 0 0 0 0 0 
0 0 0 0 0 0 0 0 0 0 0 0 0 0 0 0 0 0 0 0 0 0 0 0 0 0 0 0 0 0 0 0 
65 65 65 0 0 0 0 0 0 0 0 0 0 0 0 0 0 0 0 0 0 0 0 0 0 0 0 0 0 0 0 0 
65 0 0 0 0 0 0 0 0 0 0 0 0 0 0 0 0 0 0 0 0 0 0 0 0 0 0 0 0 0 0 0 
65 0 0 0 0 0 0 0 0 0 0 0 0 0 0 0 0 0 0 0 0 0 0 0 0 0 0 0 0 0 0 0 
65 0 0 0 0 0 0 0 0 0 0 0 0 0 0 0 0 0 0 0 0 0 0 0 0 0 0 0 0 0 0 0 
65 0 1 0 0 0 0 0 0 0 0 0 0 0 0 0 0 0 0 0 0 0 0 0 0 0 0 0 0 0 0 0 
65 0 25 0 49 0 0 0 0 0 0 0 0 0 0 0 0 0 0 0 0 0 0 0 0 0 0 0 0 0 0 0 
65 65 65 65 65 65 65 65 65 65 65 65 65 0 0 0 0 0 0 0 0 0 0 0 0 0 0 0 0 0 0 0 
65 65 65 65 65 65 65 65 65 65 69 65 67 0 0 0 0 0 0 0 0 0 0 0 0 0 0 0 0 0 0 0 
65 65 65 65 65 65 65 65 65 65 65 67 0 0 0 0 0 0 0 0 0 0 0 0 0 0 0 0 0 0 0 0 
65 65 65 65 65 65 65 65 65 65 67 0 0 0 0 0 0 0 0 0 0 0 0 0 0 0 0 0 0 0 0 0 
65 65 65 65 65 65 65 65 65 67 64 61 61 0 0 0 0 0 0 0 0 0 0 0 0 0 0 0 0 0 0 0 
65 65 65 65 53 53 53 53 53 53 53 53 53 61 61 61 0 0 0 0 0 0 0 0 0 0 0 0 0 0 0 0 
65 65 65 53 68 68 68 68 68 68 68 68 68 53 53 53 61 61 0 0 0 0 0 0 0 61 0 0 0 0 0 0 
65 53 53 68 68 68 68 68 68 68 68 68 68 68 68 68 53 53 61 0 0 0 0 61 61 53 53 53 53 0 0 0 
68 68 68 68 68 68 68 68 68 68 68 68 68 68 68 68 68 68 53 61 61 61 61 53 53 68 68 68 68 53 53 0 
68 68 68 68 68 68 68 68 68 68 68 68 68 68 68 68 68 68 68 53 53 53 53 68 68 68 68 68 68 68 68 53 
68 68 68 68 68 68 68 68 68 68 68 68 68 68 68 68 68 68 68 68 68 68 68 68 68 68 68 68 68 68 68 68 
68 68 68 68 68 68 68 68 68 68 68 68 68 68 68 68 68 68 68 68 68 68 68 68 68 68 68 68 68 68 68 68 
68 68 68 68 68 68 68 68 68 68 68 68 68 68 68 68 68 68 68 68 68 68 68 68 68 68 68 68 68 68 68 68 
