0 0 0 0 0 0 0 0 0 0 0 0 0 0 0 0 0 0 0 0 0 0 0 0 0 0 0 0 0 0 0 0 
0 0 0 0 0 0 0 0 0 0 0 0 0 0 0 0 0 0 0 0 0 0 0 0 0 0 0 0 0 0 0 0 
0 0 0 0 0 0 0 0 0 0 0 0 0 0 0 0 0 0 0 0 0 0 0 0 0 0 0 0 0 0 0 0 
0 0 0 0 0 0 0 0 0 0 0 0 0 0 0 0 0 0 0 0 0 0 0 0 0 0 0 0 0 0 0 0 
0 0 39 39 39 39 0 0 0 0 0 0 0 0 0 0 0 0 0 0 0 0 0 0 0 0 0 0 0 36 0 0 
0 39 39 39 39 39 39 0 0 0 0 0 0 0 0 0 0 0 0 0 0 0 0 0 0 0 0 0 36 36 36 0 
0 39 39 39 39 39 39 0 0 0 0 0 0 0 0 0 0 0 0 0 0 0 0 0 0 0 0 36 36 36 36 36 
0 0 0 39 39 39 0 0 0 0 0 0 0 0 0 0 0 0 0 0 0 0 0 0 0 0 36 36 36 36 36 36 
0 0 0 0 0 0 0 0 0 0 0 0 0 0 0 0 0 0 0 0 0 0 0 0 0 36 36 36 36 36 36 36 
0 0 0 0 0 0 0 0 0 0 0 0 0 31 31 0 0 0 0 0 0 0 0 0 0 5 5 5 5 5 5 5 
0 0 0 0 0 0 0 0 0 0 0 0 31 31 31 31 0 0 0 0 0 0 0 0 0 5 5 5 5 5 5 5 
0 0 0 0 0 0 0 0 0 0 31 31 31 31 31 26 31 0 0 0 0 0 0 0 0 5 5 5 5 5 5 5 
0 0 0 0 0 0 0 0 0 0 31 31 31 31 31 26 31 31 0 0 0 0 0 0 0 5 5 5 5 5 5 5 
0 0 0 0 0 0 0 0 0 0 31 26 31 31 26 26 31 31 0 0 0 0 36 36 36 5 5 5 5 5 5 5 
0 0 0 0 0 0 0 0 0 0 31 31 26 31 26 31 31 31 0 0 0 36 36 35 35 5 5 5 5 5 5 5 
0 0 0 0 0 0 0 0 0 0 0 31 31 26 31 31 31 31 0 0 36 36 35 0 0 5 5 5 5 5 5 5 
0 0 0 0 0 0 0 0 0 0 0 0 31 26 31 0 0 0 0 0 0 0 0 0 0 5 5 5 5 5 5 5 
0 0 0 0 0 0 0 0 0 0 0 0 0 26 0 0 0 0 0 0 0 0 0 0 0 5 5 5 5 5 5 5 
0 0 0 0 0 0 0 0 0 0 0 0 0 26 0 0 0 0 0 0 0 0 0 0 45 5 5 5 5 5 5 5 
0 0 0 0 0 0 0 0 0 0 0 0 0 26 0 0 0 0 0 0 0 0 0 0 0 5 5 5 5 5 5 5 
0 0 0 0 0 0 0 0 0 0 0 0 0 26 0 0 0 0 0 0 0 0 0 0 110 5 5 5 5 5 5 5 
34 34 0 1 0 25 0 0 0 0 0 0 0 26 0 0 42 20 0 0 0 35 35 35 35 5 5 5 5 5 5 5 
33 33 33 33 33 33 33 33 33 33 33 33 33 33 33 33 33 33 33 37 37 32 32 32 32 32 32 32 32 32 32 32 
32 32 32 32 32 32 32 32 32 32 32 32 32 32 32 32 32 32 32 32 32 32 32 32 32 32 32 32 32 32 32 32 
