0 0 0 0 0 0 0 0 0 0 49 1 49 0 0 0 0 0 0 0 0 0 0 0 0 0 0 0 0 0 0 0 
0 0 0 0 0 0 0 0 0 0 49 0 49 0 0 0 0 0 0 0 0 0 0 0 0 0 0 0 0 0 0 0 
0 0 0 0 0 0 0 0 0 0 49 0 49 0 0 0 0 0 0 0 0 0 0 0 0 0 39 0 0 0 0 0 
0 0 0 0 0 0 0 0 0 0 49 0 49 0 0 0 0 0 0 0 0 0 39 0 39 39 39 39 0 0 0 0 
0 0 0 0 0 0 0 0 0 0 49 0 49 0 0 0 0 0 0 0 0 0 39 39 39 39 39 39 0 0 0 0 
0 0 0 0 0 39 39 39 0 39 49 0 49 0 0 0 0 0 0 0 0 0 0 39 39 39 39 39 0 0 0 0 
0 0 0 0 39 39 0 39 0 39 49 0 49 0 0 0 0 0 0 0 0 0 0 0 0 39 0 0 0 0 0 0 
0 0 0 39 39 39 0 39 39 0 49 0 49 0 0 0 0 0 0 0 0 0 0 0 0 0 0 0 0 0 0 0 
0 0 0 0 0 0 39 39 39 0 49 0 49 0 0 0 0 0 0 0 0 0 0 0 0 0 0 0 0 0 0 0 
0 0 0 0 0 0 0 0 0 0 49 0 49 0 0 0 0 0 0 0 0 0 0 0 0 0 0 0 0 0 0 0 
0 0 0 0 0 0 0 0 0 0 49 0 49 0 0 0 0 0 0 0 0 0 0 0 0 0 0 0 0 0 0 0 
0 0 0 0 0 0 0 0 0 0 49 0 49 0 0 0 0 0 0 0 0 0 0 0 0 0 0 0 0 0 0 0 
36 36 36 36 36 36 36 36 36 36 49 0 49 36 36 36 36 36 36 36 36 36 36 36 36 36 36 36 36 36 0 0 
36 36 36 36 36 36 36 36 36 36 49 0 49 36 36 36 36 36 36 36 36 36 36 36 36 36 36 36 36 36 36 0 
36 36 36 36 36 36 36 36 36 36 49 0 49 36 36 36 36 36 36 36 36 36 36 36 36 36 36 36 36 36 36 36 
35 35 35 35 35 35 35 35 35 35 49 0 49 35 35 35 35 35 35 35 35 35 35 35 35 35 35 35 35 35 35 35 
35 0 0 0 0 0 0 0 0 0 0 0 0 0 0 0 0 0 0 0 0 0 0 0 0 0 0 0 0 0 0 35 
35 0 0 0 0 0 0 0 0 0 0 0 0 0 0 0 0 0 0 0 0 0 0 0 0 0 0 0 0 0 0 35 
35 0 0 0 0 0 0 0 0 0 0 0 0 0 0 0 0 0 0 0 0 0 0 0 0 0 0 0 0 0 0 35 
35 0 0 0 0 0 0 0 0 0 0 0 0 0 0 0 0 0 0 0 0 0 0 0 0 0 0 0 0 0 0 35 
35 0 0 0 0 0 61 0 0 0 58 0 0 0 0 0 0 0 0 0 0 0 0 0 58 0 0 0 0 0 0 35 
35 0 0 0 0 0 0 0 0 0 0 0 0 0 0 0 0 0 0 0 0 0 0 0 0 0 0 0 0 0 0 35 
35 0 0 25 0 56 56 56 56 56 56 56 56 56 56 56 56 56 56 56 52 56 56 56 56 56 56 56 56 56 56 35 
35 35 35 35 35 35 35 35 35 35 35 35 35 35 35 35 35 35 35 35 35 35 35 35 35 35 35 35 35 35 35 35 
